sgRNA Sequence	guide_group
CAACGTCGCGAACGTCGTAT	non-targeting
ACCACCGTTCGTACCGGTCG	non-targeting
AGACCGTCGTCGATCGATAC	non-targeting
GTCGTACGGATTCGCGCGTA	non-targeting
CCCCGATCTTACGTCGCGTA	non-targeting
GTTGTCGAACTCGAACGTCG	non-targeting
CCTTAACGGCAATCGCGCGT	non-targeting
CAACGTACGACGCGATAATA	non-targeting
GTACGTCGATCGTATATCGA	non-targeting
CCCCGTCGCGGTATGATCGG	non-targeting
TGGCGCGACGTTATACGCGT	non-targeting
TGGCGCCGATACGTCGGCTA	non-targeting
AGCCGATCGATTCGCAATCG	non-targeting
TATATCGCGGCGTCGTTACA	non-targeting
AGTTCGTCGGTTCGTTCGAA	non-targeting
AAGCGACGTTCGTCCGATAG	non-targeting
TAGAACCGGCGTAATTCGCG	non-targeting
ATATTCGCGTTACGCGCATT	non-targeting
CCCACGTCGGTCGCGCGATA	non-targeting
TGCCGTTACGCCCGACGAAT	non-targeting
TGGCCGTATCGCTACGCGGT	non-targeting
TGCACGACACGATCGTACGA	non-targeting
AGCCGTCGTTGGACGTAACG	non-targeting
CTCGTACGTACTCCGCCGTA	non-targeting
CCAAATTCGCGATCGACGTC	non-targeting
GACACGATAGCGCGCAATCG	non-targeting
TGTATTATACCGTACGCGCG	non-targeting
GGACGTATCGATATCGGCCG	non-targeting
GAGATCGGACCGTCGCGTTA	non-targeting
CATCGCCGTTAACGGTCGTT	non-targeting
AGGACCGTTAACGATACGCG	non-targeting
GTCCGACTCGACGCGTATCG	non-targeting
CCACGCGACCGTATTGTCGA	non-targeting
CCAGACGCGACGATATATCG	non-targeting
GCTGGTCGCGTACCGTAATA	non-targeting
GCTCTACGCGACGCCGTTAA	non-targeting
GGATCGAAACGTCGTACGCG	non-targeting
CCGCGTCCTACGGTCGCGAA	non-targeting
AGTCCGCAATTTGCGACGAT	non-targeting
TAATCGAACGCTTACGACGC	non-targeting
AAGCGTCGCGATACCGCTAA	non-targeting
GGCTCAAAACGGCGCGCGAT	non-targeting
CAGCGACGACGCGATATAGT	non-targeting
AGTCGCGAATCGTCGTCAGT	non-targeting
ACAGGTATATCGCGCGACTA	non-targeting
GAAATGATCGCGCGACGATC	non-targeting
GCTTTCGCGCGTACGACCAA	non-targeting
CGGACGATATGCGTCGCGAA	non-targeting
TCACGATACGAAGTCGTGCG	non-targeting
GTTTAATCGCACTCGACGCG	non-targeting
CCAATTAGATCGATCGCGCG	non-targeting
GTACTACGATCTATCGCGAC	non-targeting
TGTCGATGTTCGATCGAACG	non-targeting
GCGACGCGACGACTCGGTTA	non-targeting
TCCGTACGATTGATCGCCGG	non-targeting
TACCGTCGACCGGTCGAAAA	non-targeting
ATTTCGATAACTTACGCGAG	non-targeting
TTTCTATAATCTCGCGCCGA	non-targeting
CAAGCTCGATTCGTCGTAAT	non-targeting
AAGCGCTTATTACGCGCAGT	non-targeting
ACAGCGCGATCGTTCGACGA	non-targeting
ATTTATCGTTCCGACGAACG	non-targeting
CTCCGGTTATTTCGCGACCG	non-targeting
TCGTCGTATAGCGTCGTCGA	non-targeting
AGTGCGTACGTCCGTATACG	non-targeting
ACTTCGACGCCGTTTACCGA	non-targeting
GGACGCGTTATGCGCGATTA	non-targeting
TAACCGCGCGTATACGAATC	non-targeting
ATACGTCGACCGTCGACGTA	non-targeting
TACCGATCGGCGAGCGTTAT	non-targeting
ATGTAGGCGCGATACGAGCG	non-targeting
CCTCCCGTACGATCGTACGT	non-targeting
TTTACGCTCGACCGCGATAG	non-targeting
TCCATACGCGCGACCGGATA	non-targeting
GCTCGGATTAGACCGCCGTA	non-targeting
CACATGTCGACGTACGCCCG	non-targeting
AATCGACTACGGTCGCCGTT	non-targeting
TCATTGCGCCCGAGCGTAAT	non-targeting
CTCCGAACCGCGTACGTCGT	non-targeting
GCCCGAATCGTCGTCGCATT	non-targeting
CAAGGCGCCCGTTACGATAA	non-targeting
GTGTTGGCGATCGTCGATAG	non-targeting
GGAAGTTTACCGCTCGTCCG	non-targeting
ATTCGATCGGATCCGTCGAT	non-targeting
CTTCGATACGCGTCGACCGT	non-targeting
CGGCTATACGATCGCGCGCT	non-targeting
CGACCCGAAAACGTCGCGTA	non-targeting
GTGGTGCGATACGACTCGCG	non-targeting
AGCACGACGCTCGAATCGAT	non-targeting
GAGGGACGTAATCCCGATCG	non-targeting
AATCGAGTCGGCGATATCGT	non-targeting
TATCGTCTATCGACGAGTCT	non-targeting
GCATAGCGGTCGTGCGTCAC	non-targeting
TTACGTATACGTTTCGCGCA	non-targeting
GCGCGCGTTAAACGCGCGAC	non-targeting
TAGCGGATACGTCCTACGTC	non-targeting
GAGCCGCCGAACGACGTATA	non-targeting
TCCCGCGACTCGCGATACAT	non-targeting
CGTCGCGATTTATCCGCGGT	non-targeting
CCCGTATAACGGGTCGTCGC	non-targeting
TAAGCTGTAGTGTTAAACTC	intergenic
ACAGTGTAGCTAGTGATAGT	intergenic
TATGGGAATATACTACTGAT	intergenic
ATGTTACCGAAGTATGTGTG	intergenic
GGAGATCATAAGTAGTAGAC	intergenic
ATATCCTGGATGATATATGC	intergenic
GTAGGACCCTACCAGACTGT	intergenic
AGGAACCGTCCATAGACCCA	intergenic
ATACGGTATATCTTAGCACA	intergenic
TGCCCTAGATCAGTAAATCA	intergenic
AGTGCACACTCAGTAATCCA	intergenic
ACCTGAGGGACTCTAAGATA	intergenic
ATTGAGGTAAATCTTAACCA	intergenic
GTCATAGAGACCCTATGCAT	intergenic
AACGCGTAAGATCTATACCA	intergenic
AGGGCATATACCCTCAGATA	intergenic
AATAGGTGCATAGCAATTAC	intergenic
TGAGTAGTAAGTCCTCCCTA	intergenic
TAGTCCCAGTCATAATGCGA	intergenic
ACTTACTATAATGTACCCTT	intergenic
AAGAGGATAGTACTATAATG	intergenic
TGGTCGTCACTGCATCACCA	intergenic
TAGCACTGACAGTATAGAGT	intergenic
AGATATGTACAAGTAGTCGT	intergenic
AAGTAGCCTACAGTGACACC	intergenic
GTAACTATATCACTGATGTG	intergenic
GACAAGGCATACTAGCACCC	intergenic
ATTGTGGGGAACTTAAGAGT	intergenic
AGTAACAGAACGTACATCCA	intergenic
GATTACAATCCATCCCACCA	intergenic
TTAAGATATGTCCTAACCCC	intergenic
ACCGCAGTAGAGCCCAACAT	intergenic
TGTGCAGCTATATACAACTC	intergenic
AGCACGCGGTCACCTCACAC	intergenic
GTTGTGCAGCCCTAGATCGT	intergenic
AAACTATATGACCTATATTG	intergenic
ACATTACAGTAGAATAACGT	intergenic
ACTGTATAGCAATATAGTCA	intergenic
AGTGTAAGCCTGATGACCCA	intergenic
GTGGCTATAGATGTGATAGA	intergenic
AGTTCAGCTAAGTACCAACA	intergenic
GTAGATATGTAGCTACATCA	intergenic
AGAGGATTATATAACACCCA	intergenic
TGACTGGACTATCTATATAC	intergenic
AATCGATAATACCCTCCCTT	intergenic
GAGGGGCACAGTCTATCTAT	intergenic
AAGGTGATTAGCAACAACCC	intergenic
ACTACTGATGCACACTACAT	intergenic
AAGCACTTAGTGTACTACCT	intergenic
ATAGGATATGATCACTCTAC	intergenic
GTTGACTTACCATACCCTGT	intergenic
AAAGCTACAAGTCAATAGTA	intergenic
AATGCTGAATGTAACCTATA	intergenic
TAGCTAGCTAACTAGATGAT	intergenic
TGTGAGTGCGAAATATCCCT	intergenic
AAAACATGAATCCCCATACA	intergenic
TAAGTGCTAACCCCTTAAGA	intergenic
ATATAGCATACCATGTCCAC	intergenic
GACTGGACGTACGTACAACA	intergenic
ACAATACCGATATTATCCCC	intergenic
ACACCAGAGTCACTATACCA	intergenic
GTTCACACCACCTTACCCGA	intergenic
TCCTTGAGAGCCCTATGTAT	intergenic
ACTATCTCTCATGCAACACC	intergenic
CCATAGATACCCAATCCCCA	intergenic
AGCCCCATAGCATAGCACTC	intergenic
TGGAGAATTGTACTAATACC	intergenic
AAAGAGTAACTGCCCAATGA	intergenic
TAAGCGATGAATCTAAGAAT	intergenic
ATACCTGAGTTACTAACACA	intergenic
ACAGAGTACAAATACACACC	intergenic
AGCAGAATAACATAGCCCAC	intergenic
AATTAGTCTAGCTAACATCA	intergenic
AGTGACAGGTATCTCTATAA	intergenic
TAGGAGTGGAAGTCGTGTAT	intergenic
CGAGGGCAGAGTATACTCCA	intergenic
AAGAGGTTACAGCCTATATC	intergenic
ATGTAGTGTTAAGCCTATGA	intergenic
GTAGTCTAGCCCTTACAACA	intergenic
AAAGGGCCTACTCATTACAC	intergenic
AGTTGGCTTAAGTTCAACTA	intergenic
AATTAGCCTACAGTAACCAT	intergenic
GGATATGATAGCTAGAGTTA	intergenic
AGAGCCTATCAAGTAAATGC	intergenic
TATGTTGGTAACTTATTGTA	intergenic
GGTTGACCTACATACAACAC	intergenic
GGAAACAATGACCTATGCTC	intergenic
TTAGTGAGGTAAGTAACAGT	intergenic
ACACCACGAGTCCTAACATC	intergenic
AGATACTAGAGCCATCATAA	intergenic
ATTCTAATGATAGTATACCT	intergenic
AATGTCTCACATCCATACAT	intergenic
TATGGACCTAGATTCTCACT	intergenic
GAGGTTAACAATGTAAGACC	intergenic
TAGCACTGGAGAGCATATAC	intergenic
TAGGTAGTCTAATAATCCAC	intergenic
AAAGATCACAGACTATAACC	intergenic
AAGGCAATGAGTATATGAGC	intergenic
TGTTCTAGTTCAGCAACCCA	intergenic
ACCCTACCTCAGTACCACGT	intergenic
GTAGTTGGGAGATTAACACT	intergenic
AAGAATAGGCCGCTAGTCAA	intergenic
AACCGGTATAACATTTGCCC	intergenic
TGGGAGGGTCACCACTGACA	intergenic
AGTGGGGTAAGAATATTCAC	intergenic
TATTAGAGTTAGCTATACAC	intergenic
TAAAGGGTTATATAGCCTGC	intergenic
GAGGACTAAGCTCTAATGAA	intergenic
TAATGATACTAATACCCCGT	intergenic
ATAGGGACATATGACAACCT	intergenic
GTTGTATATGAGCTATACTC	intergenic
ATGGCTTGTAGTGTAACATT	intergenic
TTAGTAGTCATATATAGCCC	intergenic
AAACTCTGGATATACCTTAG	intergenic
ATAAGGAGTTACCAATAACT	intergenic
TAGACTTAGAGTTACATCAC	intergenic
GATATCTGAGAGCTAGTGTA	intergenic
AAAGCAGTACACTCTTACAA	intergenic
AAGTATGCGATCTTAAGAGA	intergenic
GTCAGATACATCGTACCTCA	intergenic
ATGTCATGTAGAGTAGAATC	intergenic
ATACAATCAGTGCTCTAACC	intergenic
TAAGGGTATTATGACTTCCT	intergenic
ATGGAGTATTGTAAGACCGA	intergenic
CAGCAGCGATACCAGATAGT	intergenic
AGAGATACATAACTACGAAC	intergenic
TATCTCAGAGCACTATCCCT	intergenic
ATAGCTACTTACAGCCACAC	intergenic
ATATAGGCCTAGTTACCAGA	intergenic
TAAGGACTATAACTCCATCT	intergenic
AAGCACGATAAATAGAACCA	intergenic
AAAGGCTCTAAGTCACTACA	intergenic
ACAGAGGCTTGATGCAACAT	intergenic
GTTGGGTCAAGACACCATAA	intergenic
ACACTGGTATACACCTATGT	intergenic
CAGGAGACTATCTAGTGTGC	intergenic
GATAGTAGGAGTGTAACACC	intergenic
ACTAACTGGTCGCTAATGTA	intergenic
AATACGTTAACAGCACATGT	intergenic
TATCTGTGTAGCATAAGATC	intergenic
AGAGTCCATAGCATGTGCGA	intergenic
AGAGATGGAAAGCTGCGTGT	intergenic
AGATAAACATATGTAGCCCC	intergenic
ATAAGCTGGTAGCTCTATGT	intergenic
AAGGACACGCGATTAGTGCA	intergenic
TAGCAACCCTAATAGAGATT	intergenic
ACAGCTATAATGCAGATATC	intergenic
TATATGTAATGACTCTGTCC	intergenic
ATATTAGCCTGTTAGAACAC	intergenic
ACTAAGACCCAGTAGTGCTC	intergenic
TAGGATAGACTGCAGCGTAA	intergenic
GATATGTCTACACAGTATAC	intergenic
ATGGATACCAGTAGCACACT	intergenic
GCAGACTGTGTACCCTCATG	intergenic
AAAGTCAATATGAGATACTA	intergenic
AAAGTAAGTTAGCTAACATC	intergenic
GAGCCTTGGAAGTACCTACT	intergenic
GTAGTATGTAAACCACCCCA	intergenic
GTAGTGTAAACACCGTAAGT	intergenic
ATAGAGATCATATCAGTCCA	intergenic
GTAGAGGTGCTATTCTACCT	intergenic
TAATCTATGAAGCACCATAC	intergenic
GAGAGAGGGACCCATTGTGT	intergenic
AATACCCATAAGCTATCCAA	intergenic
TGGACACCCATGTAGTATAC	intergenic
GTGGATCGGCACCTATACAG	intergenic
AAACTAAGTAGTTCTCCCCC	intergenic
AAGGAAGGGCCAGTATCTTA	intergenic
ATATGATTGACAGACTATCC	intergenic
TAGTAGGTATGTATCCACTC	intergenic
GTTCAGTACTAACCTATCCC	intergenic
ATAGTGTGCAATAATACTAC	intergenic
GTAGAGTATGTTATGCCCCA	intergenic
AAACTATGTATACAGTCCCT	intergenic
TAAGTTATGTACCTGAACCC	intergenic
AGATAGTGGAAACTGCTAAC	intergenic
AGGCTTGTCTAATAGAACCC	intergenic
ATGCTATGGATGTAATACTA	intergenic
TTAGGACCCTCGATCCACCA	intergenic
ACTGTCTGTAGCATTCGAGA	intergenic
AGGTGGTGTACACTTTCGCA	intergenic
GAGGCGTGTAGACAAGTGAA	intergenic
TGGGAGCCAGCGTAGAACAT	intergenic
AATGAGTCTTATCTCAGCAC	intergenic
ATGACACTATTCCTATACTG	intergenic
AGGTATATTGAGCTGTACAC	intergenic
TCACCATATAGTAACTCCTC	intergenic
AATAGGGTCTATTCTTACAT	intergenic
ATAGGGAGAGCTTATATACA	intergenic
AATGGATAGTAAGTGATCTG	intergenic
TGTATGCTAGACCCTAGTCC	intergenic
GGTGACATCTACTACAGTAA	intergenic
TAAGGATCAATAGACTGTTC	intergenic
ATACGGCTACGAATGACCAA	intergenic
ATTACCACCATAGTAAACCG	intergenic
AGGTAGTAGATTCGTCCCCA	intergenic
AATATTAAGAAGCTACAACG	intergenic
ACATCGGTCAGATAGTATTA	intergenic
AGCACACGAGATGTCCACAA	intergenic
ACGTGGACTCAACTAGATAC	intergenic
AGGAGCTCGCTCTTACCCAC	intergenic
ATGAGGTCAGATCATAACCA	intergenic
ATATACACGAGCCTATAGAT	intergenic
GGAGTTGCCCCGCTATGAGT	intergenic
AGACTGCGATAGTACACATA	intergenic
ATGGTGTATACCCAATGTAG	intergenic
AGTATTAACTGTGACCTACC	intergenic
ACTGACCACAGATCATATCC	intergenic
ACAATAGTTAACTATCACGT	intergenic
AGAGCTAAGACCACTCCCGC	intergenic
ATATAGGGTCATAAGTAATG	intergenic
AAACTGGCTAGTCCAAACTA	intergenic
GCAGTCATGACCCCAATGAT	intergenic
GTGGGTAGTTAGCACAATGT	intergenic
AATGATAGTACCCCAACTGT	intergenic
AGTGTTATCTAGTCCATATC	intergenic
ATACTGGTTGAGTCAATCCA	intergenic
TATGCCCCAACCCACTATGT	intergenic
GAGATCGAGAGACTACCCTA	intergenic
GTGCTTGTCTGATTAAGTGT	intergenic
GTCCCGCATCCTAAGAACAC	intergenic
AAAGTAGTATGCCTATATAC	intergenic
GGAATGTGCCATAACAACAC	intergenic
GAGGTGTGCCATGTATACTA	intergenic
ATAGTTAGCTTGTAGTGACC	intergenic
AGTCCTCAACGAATATACGA	intergenic
ATAAGGTAAGACGTATGTTC	intergenic
AGCACAGCTACCGAGTGCTC	intergenic
AAGAGGTAATACCCTGACTA	intergenic
ACAGTATCACACCACTATAT	intergenic
AATGGGGATTAACCATACAT	intergenic
ATATACGTAAACTCAAACTT	intergenic
TAAGCCTGCTACCATAATCT	intergenic
AGGCCTATAATACCTCTCTA	intergenic
AAGGAACCAGACCTAATGAT	intergenic
AGACTAATTTACAAGATCCC	intergenic
GAAACACCTTGTATACACCA	intergenic
AGAGCTGAAACTATGAACGT	intergenic
ACTAACGCTGTTGAGTACGA	intergenic
GTTACCATAGCTGACATATG	intergenic
TGGAGCAGCCTATTAATCCC	intergenic
AGATAGATCTACCTGCACTA	intergenic
AATATAGGACCTAATCCCTA	intergenic
TATATCGTAAATTCCTGCTA	intergenic
GAGTGTCTAAGTGCCTACAT	intergenic
GTACCGGGATCTGAGTGTAT	intergenic
GGAGCAACATATGTAGACGT	intergenic
AATCAGTTAGTCAAGTACCC	intergenic
TCAGCACTCAGTTAGTACAT	intergenic
AGAGTCTAACTTATGTCCCC	intergenic
GAACTAGGTCACATATCTAC	intergenic
GAGGTATGACGATTGTATAT	intergenic
GGTGCCACTGTGATATACTC	intergenic
ATGGATACTATAATTCACCC	intergenic
TCAGGGTAATATTAGTCCCA	intergenic
ATATTCACCTATGCTACACA	intergenic
GTAGATATTTCCCTAAACGC	intergenic
CAGGAACCTGAGTACTACTC	intergenic
GTAGACATTAAGCTCCTACA	intergenic
AAGTGTCAGATACTAAGCCC	intergenic
TCCCTGGCTATATTACCCAC	intergenic
AAGATAGGTACATCCTGTTA	intergenic
AGAGTGTGAAGTATACCTCC	intergenic
GCTAGGGTTCTACAACACAA	intergenic
ATATCGGATCCATTCCAACT	intergenic
AGGATAAGGTACCTCTAATT	intergenic
AGGGCTTACAGTCTCATCGT	intergenic
ACACGGGAACGAGAGTCTGT	intergenic
ATTAGCTATAGTGCATATGA	intergenic
AAGCAGGTCAACCTAATACA	intergenic
AGATATGTCTGACTCCTACC	intergenic
AGAGAGTGGTCCAAACCAGT	intergenic
TGATGCACTAGTTACAACCC	intergenic
GCTGACCCTGAACATCATAT	intergenic
AAATCATACTAAGTAACATC	intergenic
AACTAGAGATTGCTAGCCCA	intergenic
GGAGGTTAAGAGCTATATAG	intergenic
ATACATAGTAAGTCTTACTA	intergenic
GTAGCCCTAAGAGTAATACA	intergenic
TAGGCTCTAGAGATCATACA	intergenic
GAGTTATGTAGCCCATATCA	intergenic
GAATTACTCCAGCTAATACA	intergenic
ACTGTCTCAAGTCCCTTACA	intergenic
AGAGCCTCTGTGCCACTATA	intergenic
AGATACGTTAAAATGAACTC	intergenic
AAATGGATTAAGCTTCACCC	intergenic
AGACAACTATAGCTAAGTTA	intergenic
AAACCTACATATGACAGTAA	intergenic
AGCTATTGAACACCCCTACT	intergenic
TGTGTCCAAGTGTAATGCTC	intergenic
AGACCCTATAGACAGATCCC	intergenic
AATGACCGTAATATACTACT	intergenic
AGGTCAGATATCTAGCACGT	intergenic
GCTGGAATCACGTACTACGT	intergenic
AATTATACTTGAATACCCAC	intergenic
TAAAGACATGAGTAGCACTA	intergenic
TATGTTACAAAGCCCCAGTA	intergenic
GAGAAATATAGTAATCGCTC	intergenic
GAGAGGTAAGCTCTAAATCC	intergenic
AGTTCTGCAGAGTACCATTA	intergenic
ACATCAAGTATAAAGCCCTA	intergenic
GGTGGTGATTGACAGCCATA	intergenic
TCACTCTCACCACTATGCGT	intergenic
ATATGGGTAGTGTTATCTCC	intergenic
TATCAACACATAGTAACATC	intergenic
TAAAACTAGATCCTATAACA	intergenic
ATTGTGGATTCTATACAGTA	intergenic
ACATGAGCAATAGTCTATAT	intergenic
TTATTGACTACTGTACCCCA	intergenic
ATTTAGCGGAGATAGAATGA	intergenic
ATGATCTGTGCAGTACAACT	intergenic
ACTACTCCGCAATAGAGCTA	intergenic
ACTCCTACTAGCCAAAGTCA	intergenic
GCAGAGCTTAGATATAATGC	intergenic
ATAGCATTATACCTAATTGT	intergenic
ACCGTGGCTACTCATTACAT	intergenic
AATCTATGAAGAGTGTACTA	intergenic
GTTGAGGTAGATCCAAACTT	intergenic
AGGGCTACATACCTAAGATG	intergenic
AGTGTGTGGTGCGTATACCA	intergenic
GATTCCTAGACAGTACATGC	intergenic
AGTGTAGACCATGCAAACTT	intergenic
GATGTAAGTCAAGAGTCCAA	intergenic
AGTAGAGGGACTAGTAACCC	intergenic
ACAATTATACCACTAGACCC	intergenic
AGAGCTCTTAACTCTCCATA	intergenic
GTAGACTGTAAGATATGAGC	intergenic
AAAGAAAGTTGTAACAACCC	intergenic
CACACGAGTAACGTACTGCA	intergenic
ATTACAGAATAAGCTTACGT	intergenic
GATGGTATAAGTTCTAGCTC	intergenic
AACATGACTCAACTGTACCC	intergenic
GTTACTATAGAAGAGTAATC	intergenic
ATCTAGACATACGAACACCA	intergenic
GGAGGCAAGACGCAGTAACA	intergenic
ATTATGACAGCCCTAGCTAT	intergenic
TAACTGGATGTAATCTACCC	intergenic
GACTGGGATATGCTAGCACC	intergenic
TAAGGCTATCAATCCAGATC	intergenic
TATGGACTGCTAAAGATCAC	intergenic
TAACACTGGATATTTAACGT	intergenic
ACTCTGCTAGCACTGAGCGT	intergenic
TATAGGACGCATGAGATATG	intergenic
CAGGTCAGCAGCGTATCCTA	intergenic
TAGTGTGTAAGTGCTAATGC	intergenic
GAACTATTGTACCTAAGACT	intergenic
TAGCTGTCAGACCACGATGC	intergenic
ATTTAGAGTGCTCCCACCCA	intergenic
AAATGCCTAGAGTTATACCC	intergenic
GCAGTGCTCAATCTAAGAGT	intergenic
GGGATTAGAGATCTGTATGC	intergenic
TATGAACTACAACCCTAAGA	intergenic
ACTTACATGAACTAGAACGC	intergenic
ATAGACTAAGTCTAGACTCA	intergenic
AGTAACACCCCTGTGTATGT	intergenic
TAGTTAACGAAGCCTACAGA	intergenic
AGTGCTTAGTGAATAAGCTC	intergenic
AAGATGCTAGAACTGTGTAG	intergenic
AGATAGGATCCCCAGTACTC	intergenic
AGGTAGGAACTCTGCTATGT	intergenic
GCAGCAGACATAGAATACGA	intergenic
ACATACGCTAGTAACCGCCC	intergenic
CATCCTGATATGTAGAACCC	intergenic
AATCTAGGTCAATAATATGC	intergenic
GAGCAGGGCTAATATATCAC	intergenic
AGCTCTCCTAGTCTAAACCC	intergenic
AGGACACCCTGATCTTATGT	intergenic
ATAAATGTACACTACTACTC	intergenic
TAGTCTACTAGTTAGCACTA	intergenic
TCAGAGCACCCTCAGATATA	intergenic
ACCCCATAAGCTCTATCCAC	intergenic
AGGCTGCACTTAGATCACCC	intergenic
GTAGAAGGTATCCTATATAC	intergenic
GCTGGGACCTGTGCCATACA	intergenic
ATACCCCTAGTACTGTGATC	intergenic
ATAGCTATGACCTCCTAATG	intergenic
AAACAGAGGTACTCTAACCC	intergenic
ACAGGACCTAGATATATCAC	intergenic
TGTGTGCTAAATTAGACCCA	intergenic
AATATGTTCAGATACTATCC	intergenic
GTGGAGGCCCAGTACCAATA	intergenic
CTGGAGACTAGTGTACAACA	intergenic
AGGGTGTATATAGTGATACC	intergenic
GGAAGGAGGTAACTACTAGT	intergenic
CAATAGTAGACGCTAGAACT	intergenic
AAGTGAATTAGTCCCCACCA	intergenic
TATGAGTCTAAACCATACAG	intergenic
AGAGAGTGGATTAAGTTAAC	intergenic
ATACCCTTAAGATACAGCTC	intergenic
ACATACCCTTAAGAACCATC	intergenic
GAGAGGGTAATAGACCCTGA	intergenic
TCAATATATCACCTAGAACC	intergenic
TAACCCATCAGTCTATAGAT	intergenic
GTGCTACCAGTATACTCTGA	intergenic
TCTGTCTATACCTTGAGCTA	intergenic
AGAGATTGTGACCTGAACAC	intergenic
GCATGTGCGAAGCTAAACTC	intergenic
GAAGCCTGTCAGATATGTAT	intergenic
GAAAGGGGTTAGTTACTACA	intergenic
TAGTGGGGATTAATAAACCC	intergenic
AGGAGCAGTAATCTAAGCTC	intergenic
AAGGAAGAGCTAATAATACC	intergenic
AGAGTCTTGACCGAGTACTA	intergenic
TATGTGTATACGATCCCATT	intergenic
TAGGTCAATAGCCATATACT	intergenic
AAAACTTAGTGTATAAACCC	intergenic
AGCACCTATATGTACCACCA	intergenic
ACAGGCGCAGAGCTCTCTAC	intergenic
TAAATATGAACCGTTCACCA	intergenic
GTAGTAGCTAAACATTACTG	intergenic
AAGAGGGTGTTAATGTACTA	intergenic
AAGTTCAGTACCCATTACTG	intergenic
AGAGCCTAAACAGTGCATAT	intergenic
AAAGCTCCCAGTATGTACCA	intergenic
ACAGACCAAGTCTAATACCC	intergenic
AGTCCCAGTAACTTCACATA	intergenic
TAGGACTACAGAGATCGCAG	intergenic
AGAACCCCACACGTATACTT	intergenic
GTTAGGGTGAAGTCATACTA	intergenic
ATAGTTATAGCAATCTTCCA	intergenic
GTTACTACAGTCTTACCCCA	intergenic
AGAGTAGTGAAGCCAATTCT	intergenic
GTAGCAATACTCCTAACTGT	intergenic
TGGAGGTACTGCCTATAAGT	intergenic
TAGGTGCCGATATCAGAACT	intergenic
TAAGTAGGCAAGCATTCTAG	intergenic
TGTGGGATCTGACTAACTCC	intergenic
AGATTGACCGAAGAGACCCA	intergenic
GTGCAATGTAGTCTGAACAC	intergenic
GAACTAGGTGCATACAATCC	intergenic
AGAGGATTCACCTATTACCC	intergenic
ACTGCATGCACTCTACAAGT	intergenic
TGGGTACTTAAGTAGCTACT	intergenic
AGAGAAGCTCTTGTGCACCC	intergenic
AATTAGCGACACCCTCTCAG	intergenic
GTTTACTAGAAACCATAAGC	intergenic
GACACGGAGTGCATATGAGT	intergenic
GAGGTATCCTGAGAGCTAGT	intergenic
TCTGCTAGGACAGTACACAC	intergenic
AGTATAGCCTGAGTATTACT	intergenic
AGAGCTATAGGTCCCCAGTA	intergenic
ATCACACCATAGGTAAATGC	intergenic
TAAGTAGATAAGGTAATACC	intergenic
AGCCCGAATAGGTAGTATGT	intergenic
GCTAATATAAGGTAACACCC	intergenic
ATAAGTAGGATACTACAGGC	intergenic
ACTGTCTAGGAACACCCATG	intergenic
TTACCAATAGGCCCTCAGTA	intergenic
AATTACTGGAGGCCATCGTA	intergenic
AGGCATAGTAGGCAGTAACA	intergenic
AGGCCGTGGAATCATATGGA	intergenic
TAGTAGACTAGACACGGCTA	intergenic
TCTGCTTGTAGGATAACAAC	intergenic
GACAACACTAGGTATCACCA	intergenic
GAGGAATAGATTAGGACCCA	intergenic
CAAGTGAAAGAGGACTACCA	intergenic
AAAGATACAAGGTAGACCTC	intergenic
TGCACCAATGGACTAACCCC	intergenic
AGTATCTCGGTGATATCCAA	intergenic
GTGGTAACAAGGTAATATAC	intergenic
TAATAACCTCGGTTGTACCC	intergenic
GCAATTATGAGGTACCTGAT	intergenic
AGTGATAGGCGGTATATCTC	intergenic
ATTAGAGGTGGACTAATACC	intergenic
AGGTTATCCAGGTTAAGTAG	intergenic
GATAGATGTAGGACTTAACC	intergenic
AATGTCAGTGGAATAAGTAT	intergenic
GAGGCCCTAATGGATAATAC	intergenic
AATTCTAAGACAGTATCGGA	intergenic
ATGGCTGTCTAGGAGTGAAT	intergenic
ACAAACCTGGTACTTCACTA	intergenic
TGAATCTAGGCGTAGCCACA	intergenic
GGACTAGACCGAGATAAGGT	intergenic
AGGACTGATAGGATCAGTAT	intergenic
AGAAAGGATCAGGCTCCATA	intergenic
TAGCTCAATATAGACACGGA	intergenic
GTGGAGAGTAGCTTAGGATC	intergenic
ATAGATCCTAGAAGGCACTT	intergenic
GATGTAGGTAGGCCATCGAC	intergenic
AGGTTAGCAAGGCCTAGATT	intergenic
ATAAGTCCCAGGTTACATAT	intergenic
TGCAGGTCGGCACCCACCGA	intergenic
GAAGTTAAGAGGCTCCACAA	intergenic
TAATAAGAGTTAGATCTCGG	intergenic
GATCTGTTAAGGCCCATTGT	intergenic
TAGGTAGGTGGAGCTCCATA	intergenic
ATAGTCCGGGTATTCATGCA	intergenic
TCTATCTAGGACCAATGCTC	intergenic
AGAGGCCTACAGGACACATA	intergenic
ATAGACTGTGGTATGCCCTC	intergenic
TCAGGGCTCAGGCTAAACGC	intergenic
GCACATGCATGGTATAGCTC	intergenic
GTAGGGTTGGCTAACATAGA	intergenic
AGGACCCCGTGGTTATACCC	intergenic
CATGCTTCTGGACCATACCT	intergenic
TCACCCTCGGAGCTATAAAC	intergenic
ATAGTCAATGGTAACAACTC	intergenic
TAGTTGAAGGCCTAACCAGT	intergenic
AGCTAGGAAGGACTACTGAT	intergenic
ATCTAATCTAGGCTATGAGC	intergenic
AAAGACAATAGGATTACCAC	intergenic
AAGTAGTCAAGGCAGCACTT	intergenic
TGAAAGTAGGATACCAACCA	intergenic
GCAGAACAATCCTTAATGGA	intergenic
ACAATTAGGGCAGATATATC	intergenic
AATACGTGTAAGGTTACATA	intergenic
AGAGTTAACAGGCTATCCCA	intergenic
ACTGAGTATATACCATTGGT	intergenic
GCAAACTTAGGCCCATACCA	intergenic
GTACTCAATCTACTATAGGC	intergenic
TTATGAGTACAGGTAGACTA	intergenic
AGAACGGTAAGGCATTAGCA	intergenic
ATAGGATAACATTAGTGGAT	intergenic
AGCATCCTGCCCCATATGGA	intergenic
ATAGCTAAGGACTCAAGATA	intergenic
TCTGTGAGTCCGCGCATGGT	intergenic
AAGGATGCAGGACTGATATT	intergenic
ATCAACAATACGGTATATCC	intergenic
AATGTTCGAGTGGTATATCC	intergenic
GGAATAGACAGGAGTCCCCC	intergenic
CATGCCCGAAGGATCAACAG	intergenic
GCCACCACCTGAGATAGGAT	intergenic
ACACCACTATGGTCATGACA	intergenic
TGAGACTGTCCCCTCAAAGG	intergenic
TGGTCTAGTTGGAAGTATCC	intergenic
AGATGGACTCAACTGAATGG	intergenic
AGTGTCAGTAAGCGGTGAGT	intergenic
GACATCTGAATGGACCACTA	intergenic
ATTATCCGGAAGTGGTAATA	intergenic
TAGGAGATACCAGGTTGATA	intergenic
GTAGCTGAGATACGGAACAT	intergenic
TAGCAGTTATAGCAGGCATC	intergenic
AGTCCCTAATGGCATTATGA	intergenic
TAACAGATAACCCTAATTGG	intergenic
ACAGAATCGGCCCTTAGTAT	intergenic
AAGCATCTGGAGCACTACAT	intergenic
GCGGGTGGTAGGTTGACATC	intergenic
GTGTACATGCCGGTGAAATA	intergenic
GAGATGCACAGGCTAATCTA	intergenic
ATTCATAGATGGCTATCAGT	intergenic
GTATTGAGGGCATACTATGA	intergenic
GGTAGCACCAATGGATCATA	intergenic
AATATACATAATAGGATCCC	intergenic
ACAGCGAGAGGCTTATCCGT	intergenic
AGAGTGACAAGGTCCTATAA	intergenic
AGAAGGCAACATGTCTATGG	intergenic
AGATAGAGTCATTCCACGGA	intergenic
ATTTAATGTAGGCTGAACCA	intergenic
ACTTCTGGTCAATAGTAGGT	intergenic
TATGTAAACAGTGTAGGACC	intergenic
ATTGCACAGAGTAATCTGGT	intergenic
GTGTAGTGTAGGTAGCAAGT	intergenic
GACGCTAAGGTACTACTATC	intergenic
GTGGCTATCAGGCTCTATAT	intergenic
GAAGCAGATCAGGTATAATA	intergenic
ACAGTGAATAGGCCATGCTA	intergenic
AACATGATGAATAGGACCAC	intergenic
ACCGGGTCTTAGGTACATAT	intergenic
AGCATGTACTAGGCTCACAA	intergenic
ATACCCTTAGTGGTAAGACA	intergenic
AGAGACATGGTATATCCAGT	intergenic
AGAGTATTGGTATACTATAC	intergenic
AGACATATGGACCAAAGTAT	intergenic
ACATAGACTAAGGCAACCTA	intergenic
AGACCAGTAAATCGGAGCAC	intergenic
AACATCTGTGGAGACTATAT	intergenic
GAGCTATAGGACGACATAGA	intergenic
AGACAACCCTAAGGTTACCA	intergenic
AGGTAGACCTTGGTACATAA	intergenic
TAAGAATAACTGGTGTACTA	intergenic
ATAGCTATGGTGTTAAATCC	intergenic
ACATCTTATTAGGACACCCA	intergenic
AGAGAGTAGTGGTTACTGAC	intergenic
GGAGTAGGGGAGTCTATGAA	intergenic
GACATATAGCTAGTACAGGT	intergenic
AATGTGATACTGGTATATGA	intergenic
TCAACGCAGAGGCATAGCTA	intergenic
AGAGAATAATAGGTACCCAT	intergenic
GAAGCTATAGAGAGGTATAC	intergenic
AGACTTACGGAGCTACATCT	intergenic
ATGGATATGAATAGGTTCCC	intergenic
GAGTAGTATTAGTGGAGCAC	intergenic
TGCAGCTCTACCTACATGGT	intergenic
AGAGTGTATGGTACCCACGA	intergenic
GCCTACCCTGACTACTACGG	intergenic
TTAGCATATAGGAGCCCTAC	intergenic
AATATCTTAGGCATATGTAG	intergenic
TAACTTATGGAGCATATAAC	intergenic
GCCCCTTTGGAACTATATAC	intergenic
GATGTTATAAGGATCCACAA	intergenic
AAAGACTTAGGTTATAACTC	intergenic
AAGTAGAGTTAGGATTGCTA	intergenic
ATAACCTAGAAATAACCGGC	intergenic
AGAGTTAGGGTCATAACCCA	intergenic
ACAAGACCAAGGTATCACAC	intergenic
AAGTTCCAGGAACCACGCTC	intergenic
CATGTAGTATCCCTAGGCAT	intergenic
GTGTTGACTAGGACTATCCC	intergenic
GGTACGCCGGAATAAAGCTC	intergenic
TCAGCCGTAGGATACCATGC	intergenic
AAAGACAAGGACCTAATGAG	intergenic
TTAGGCACGCGGTAATGAGT	intergenic
TATTAACGGGAGTTATATCT	intergenic
ATAATGAGGTGGATAACATA	intergenic
GACACTGGAAGGTATATAAC	intergenic
GAACTTAAGAGGCAAGCCAT	intergenic
GTTTCAGTAGGCCTATGATA	intergenic
GAGCTCACGCGGTATCAACA	intergenic
AATTCTATAAGGATGTCTCC	intergenic
TAAGTGGATACGTAGATTGG	intergenic
AATATGACAAGCATCCCGGA	intergenic
GAGGTAGAACACTAGGTGAA	intergenic
GTACCTCAGATACTGTAAGG	intergenic
ACTTAGACAAGGATTCAAGT	intergenic
AAACCCTCCCTGGTATATAG	intergenic
AAACTGGGTAGGAATTATAC	intergenic
TAAAGCAGTAGGTCAACCAT	intergenic
ATAGATACCAACCTTTAGGT	intergenic
GGAGACTAATGGTTGACCCA	intergenic
GTACATGGAAGGACATACGT	intergenic
TATGTCTATTGGCCACTCGT	intergenic
GTGTTCAAGGAGCTACACGA	intergenic
AGTACTGTAACATTAGGCAT	intergenic
GTTGGTAGTTCACTAGTGGA	intergenic
AGGTTCCGGAGGTTAGAACA	intergenic
GATGATGGCTTCCATATGGT	intergenic
ATACTTAAGAGGTACATTCA	intergenic
ATTGTAGGTCCATTGTAGGT	intergenic
AGAACCAGAATACCTATGGA	intergenic
AAGCAGACTATGTTGGATGC	intergenic
ATAGCATGAAGGTATGACAT	intergenic
GCCTAGGTCATGGTATACAC	intergenic
AGTACAGCTATAGATTAAGG	intergenic
GAGGTGTGGAGGCGTAGACA	intergenic
CAGGAAGTGGAGCTCTACAT	intergenic
GAATACCTGAGTGGCCTAGA	intergenic
TGTATCTTGGACTATAGTAA	intergenic
AAGAGCGAATCGTAGATGGT	intergenic
ACAGATGGAAGGTCCAATGT	intergenic
AGAGTATGATGTGGTATACA	intergenic
AGAGTCCTGAGGTATGTATG	intergenic
AAGGAGCGTTCACCATCGGT	intergenic
ATAGTGCCAAGGATTACCCA	intergenic
GTTCTTAGGGAATTACGCAA	intergenic
GTACTTGCAAGGAAGAACGT	intergenic
AAGGCTATATGGCATTAAGA	intergenic
ATAGCACAGGAACAGTACTA	intergenic
GAACTGATGGTCTACTAAGA	intergenic
GATGAAGTGGCATTAACCCC	intergenic
TAATGGTAAAGGCCCCTAGT	intergenic
AGATCGCAGCAGGCATTGTA	intergenic
AAAGCGAGGAATCTCAGGTT	intergenic
TATGAGTCTAGGATACTCAA	intergenic
GGAATAGGTCTGGTTAATAC	intergenic
GTTCTCTGAGGTATAATCCC	intergenic
TCAACAGGTAGGTAGTCTAC	intergenic
TTGTTCGTAAGGCTACTATA	intergenic
ATTGCTTACAGGCTATTCTA	intergenic
GATACGAAGAGGCTATATTC	intergenic
ACAGTTAATAGGTAGAGTCC	intergenic
AAGTGCATAGGCGTATGTGA	intergenic
AGAGTATAGAGTAAGGCTCC	intergenic
TAACCGAGCAGTGGACATGT	intergenic
AGGGTGTAAATAAGGACCCA	intergenic
TGTATCTGGACTTACTATGG	intergenic
TTACCGGGCCAGGTTAGTGT	intergenic
AAGGTCGTGGATTATTGCTC	intergenic
GCAGGGTGACAGGTACTCGT	intergenic
TTGTTGTAAGGATTGATCCA	intergenic
GGCTCCGAGGAGCAACATGA	intergenic
GAGGCTGCTATAGTACACGG	intergenic
GATGTGGATGGTCTAGCTGT	intergenic
AGAGTAGATTGGCAGAACTA	intergenic
AATACAGTGGTACATAATCC	intergenic
AGAATGAGGGTCTAATGTAA	intergenic
CTTGGCGTATACTATATGGT	intergenic
AGGACAATCAGGCAATCCCC	intergenic
AATACTTAATCCCTAGGACT	intergenic
GGGTATTAGGACCTAGCATT	intergenic
GGAGATACCTGGTCACACAC	intergenic
TCTATGCTAGAGGACTGATA	intergenic
TAGGGCCGGCCATGGAGCAT	intergenic
AGAGAATGAAAGTATCGAGG	intergenic
GAGCTTAGAGATGGATACGT	intergenic
GCTGTCAGTGGCATAAACGT	intergenic
AAGTAGATCGTGGTTAACCA	intergenic
TGACTACGTGCATGGATAGA	intergenic
AAAGTCACGGATTTCCACCC	intergenic
AATTCTACTGGTATGACCAA	intergenic
TGGACACAGGTACACTATGC	intergenic
TAAGGATAGGCATTGCTAGT	intergenic
GTATAATTAGGTGTAGCCAC	intergenic
AGCTTCGTACCTCGGTACAC	intergenic
GATGGGTGACAGGTATATAT	intergenic
AGATTGCTGGATACCATATG	intergenic
GTATGAGAGGAATTAGTACC	intergenic
ATGGACTTGCACATAATGGT	intergenic
GAGACTTAGGACCTATAGAT	intergenic
ACTATCATCTATAAGGTCAC	intergenic
GAATTAACCTAGGTTAGATC	intergenic
AACGTGTAAGATATCTATGG	intergenic
AGAACATAGGAGTCATATAG	intergenic
AGTGGCAATACAGACTAGGA	intergenic
GCAGTGCACAAGGTACATAA	intergenic
GTGTCTATGGATCTCATACT	intergenic
AAGCGCTAGAGGTTAGATGT	intergenic
TAAACAACGGAAGAATACCA	intergenic
ATACCTTGGGACTATTCTAG	intergenic
ATTATGTAAAGGTACCCCTC	intergenic
ATACCACGTCGGTAGAATAA	intergenic
ACATAGTGGGAGATATCCTT	intergenic
GAGGTGTTACTATCATATGG	intergenic
ACTCAGTAGGTGTAGTACCG	intergenic
AATAACTGGGACCACTATAG	intergenic
AGACTCAGAAGGTACCTATT	intergenic
TGATACCATAGGCTATTGAC	intergenic
GTTATTGAACTACAGATAGG	intergenic
GAGGTAGAGGTCGCAATATC	intergenic
TGAGCAGGAAGGTACCCCAT	intergenic
ATACCAACAGGTATCAGATC	intergenic
AGAGTCAGTGGATAGTATCC	intergenic
AAGTTATCAAGGCAGTTATC	intergenic
GAGCCTGACACATCAAGGTA	intergenic
AGAGTTAGGCACTAGGTATA	intergenic
AGAGCATACTAGGAGAACTC	intergenic
GAGCTGATGTATCTACTTGG	intergenic
AAGGGCTAGAGGAATAACTC	intergenic
TAACTGCAGTGGTAACTATC	intergenic
AGATGGCTGTTCCTAATGGA	intergenic
GTTACTATAGAAGGTTGCTA	intergenic
TAACCTAATGATCTACTTGG	intergenic
ATAGAAATGGTCTAGTCCAC	intergenic
TTGACTGGCACACTATGGGT	intergenic
TCCCCTATAGGGTAGTGTGA	intergenic
AGGCAGTCGGGTGACATAGT	intergenic
GTAGATGTCTCGAGGATGGA	intergenic
ACGCGGTAGGGAGAGACCTC	intergenic
AGAGCATAAGGGTCCACAGT	intergenic
ACAATCCAAGGGCTATCACA	intergenic
AGAGCAATGGGTGTATAGAT	intergenic
GCAGCGGAGACAGGGTCATA	intergenic
ACAGTCTTAAGACTAATGGG	intergenic
GTAGCTAACTGGGAACACCA	intergenic
GTGCAGGTATGGGTACCTAT	intergenic
AAGGTTATGGGACTGCAATA	intergenic
AATTAGAGTCCCATAAGGGT	intergenic
GTTAGCATAGGTCTAAGAGG	intergenic
GCAGCCCACAGGTATTAGGT	intergenic
TAGGAGCTAAGACTAAGGGT	intergenic
AAACATATGGGCCACTACAC	intergenic
GCTGCTACACATAACAGGGT	intergenic
AGAACTATGAGGGTAATGCT	intergenic
AAACCATGTGGGCTAAGACT	intergenic
ACAGCTAATAGGTAGGACCC	intergenic
TAATAGAGGGGTTAATCTAG	intergenic
TAGGAAGCTGGGTTATATGT	intergenic
GACACTAGAGGGTTATACTC	intergenic
TATGTATAGGGAATACCCCC	intergenic
ACACAGTTGGTCCTATCAGG	intergenic
TGAGTATAGGGACCATACAA	intergenic
TGTGCGACACACGACTGGGT	intergenic
TATACTATATGGCTATTAGG	intergenic
GAAGCTGATGGGTTATCTGT	intergenic
GTTGTGTCGAGCCACAGGGT	intergenic
AGTTTGTGGGGTGTACATAT	intergenic
GCTCATGGTTGGCCTATGGA	intergenic
GTATGATTGAGGGATATAAC	intergenic
TATATGACATGGGACCTAGT	intergenic
AGGTAGGCTATTGGGTATGA	intergenic
GATAATGTTAGGTGGTACAT	intergenic
GGAATGAAGGGACTATACAC	intergenic
AGTACTAGTCAGGTATATGG	intergenic
TATTAACACTCCCTAAGGGA	intergenic
AAGTACTACTAGGACAAGGT	intergenic
GAGGCTTATGGGCTATGCTA	intergenic
GCAGCTATACACTAGGGAGA	intergenic
TAGGACATGGACGTATATGG	intergenic
ACATACAGTAGGGAGTGTTA	intergenic
TGATGTTAGAGGGTATACTT	intergenic
GTCGATAACTGGCTTATGGT	intergenic
GCAGAGTAAGGGCTCTAATT	intergenic
GTTTACTGGGGAGTACCTGT	intergenic
AAGAAGCCGCCGTTATGGGT	intergenic
ATTGTATCAGGGATATACCC	intergenic
GGAGAGTGTCCGGTAATGGT	intergenic
GTATAATAGGTGGTATTCAC	intergenic
ACATAGCGGAGGGTCTGTAC	intergenic
GTAGGATTGGGATTGAACAC	intergenic
CAATACATGGGACAGATATC	intergenic
GGGATGCAGGACCATAAGGT	intergenic
ATGACTGTAGGGCTCATGTT	intergenic
TAATGATACAGGGACCTGTA	intergenic
TATGCTATGGGACTATTGCA	intergenic
ACAATGGCTAGGGCTCGCAA	intergenic
GTGTCCTCGGGATTATTCCA	intergenic
AGAGAATGTGGGTACAACAT	intergenic
GTATAGTGGACGGACATGGT	intergenic
AAGTTAGTAAGACTTATGGG	intergenic
TATGGAACCTCATAATGGGT	intergenic
ACTATGTATCACTAGGGTAA	intergenic
AGAATGTGAGGGTAACACTA	intergenic
AGATACAGCACGCTCAGGGT	intergenic
AAAGTGAGGGGTTTATACCA	intergenic
GCTGCCTACCTAGCATGGGT	intergenic
GAAGATCAAGGGTGATGTAT	intergenic
AGGTCTACAAGGATATAGGT	intergenic
CCTACTACAAGACTAAGGGT	intergenic
AGTATCTCACGGGTATTCCC	intergenic
GTATGATGGGGTGTGCACGT	intergenic
GTTATTAGAGGGCACGTATC	intergenic
ATATCCATGGAGGCAACGTA	intergenic
AGAGACAGCTGGGTGCACTA	intergenic
AGGATCTGTAGGTACATGGC	intergenic
AGATAACTAGGGAACTATCT	intergenic
ATAGAATATTGGCTAAGGAC	intergenic
TGAGTCTGGGGCTCTTGATA	intergenic
AGGTGGCTCTCGCAGATGGG	intergenic
AAAGGCATACGGTAGTATGG	intergenic
ATTATCAGTAGGTGGATCGT	intergenic
AGAGTTTAAGGGATACAACC	intergenic
TCTGAGGTGCGGGTATTATT	intergenic
CTAATGTTGGAGGTACCTAC	intergenic
GGTGTAGTAGGGCCCACTGA	intergenic
TGTTGGATAGGGAATTACCC	intergenic
AGAGCTATAGATGTAAGGGC	intergenic
TATCTGGTAGGCCTAATGGT	intergenic
ACTATGCTAGGGCAATTATA	intergenic
AGAGTAAGGGCCCTTATGGT	intergenic
TACTCACAGGGACTAACATC	intergenic
GAATGTATAGGGTAGTTCGT	intergenic
ACAATCTCTGGGCCAATACA	intergenic
GAGTAGTTAGGGAAGCCGTG	intergenic
ACTATCACGGAACAGTAAGG	intergenic
TTAGTAACTAGGTTAGGCAT	intergenic
ACAGTACCTGGGCATACCCA	intergenic
GAATAGCCACGGGAGAACTC	intergenic
TATACCTAGGGATTAAATGC	intergenic
AGTCATATCTAACTAAGGGA	intergenic
AATTAACACTGGTGGTACCC	intergenic
ACACTAGAGGGCATAAGACC	intergenic
AAAATATAGGTGGAGTACAT	intergenic
GCAGCTACAAAGTTATAGGG	intergenic
AATATCCCTAGGGAATTAGT	intergenic
GTACCGAACAGGGTCTTAGT	intergenic
AGGGTAGAGCGCTAATGGGT	intergenic
AGGATCAGGACCCCTCGGGA	intergenic
ATAAATTCAGGGCTATACTT	intergenic
ATAGATAAGGGCTAGCCAGT	intergenic
GAACTCTGTTAACTACAGGG	intergenic
AGAAACTAGGGTTACAGCGT	intergenic
ATTGTGTTGGGCTTATCCAA	intergenic
GTGGATAAGGGAGTACGCTA	intergenic
GCAAGACCGTGGATATAGGT	intergenic
AATGTCAGAGGGATCAACTA	intergenic
ATATATTGGGGTTACTATGT	intergenic
AGAGGTCATGGGCTAAACTA	intergenic
TGAGGGTTATAAGGGATATA	intergenic
TAACATGCTGGGCTAACATA	intergenic
ACAGCAGAAGGGTTATCATC	intergenic
GCTGAGACCAGGCTACGGTT	intergenic
TATCCTACAAGGTATTGGTA	intergenic
TCAGCACTAGGGAATCACAT	intergenic
GAGCCTATACGGGCAGCTCA	intergenic
GATGAACGTAGGTGGCCCCA	intergenic
TGTCAGATAGGCTTATGGCT	intergenic
ACTGAGCGTTCCCACAGGGT	intergenic
AATGTGACAGGGTAATACAT	intergenic
ACTGACTAAGGGTAGAACCC	intergenic
ATACAAACTTGGGTATACAC	intergenic
GCAGAAGTCACCCCAAGGGT	intergenic
GATATGAGGGGACACCTACT	intergenic
AATGTAGTGGTAGGATCGTA	intergenic
ATATTAACGTCAGGGTACAT	intergenic
ATTATGTCAAGACTATAGGG	intergenic
ATAATATTAGGGTCAACTCC	intergenic
GTAATACCTTGGGAATCCTA	intergenic
AGGGTCAGAGGGTCTATAGA	intergenic
AATAAACGAGGGTCCAACTA	intergenic
AAGGTATACAGGGTGATAGT	intergenic
ATAGTCTCAAGGGCACACGA	intergenic
GCAGCCAGTGGACCATGGTA	intergenic
GTAGGACAGGGCCTTAGTAG	intergenic
TGTGTGTATTGGCTCCACGG	intergenic
AAGTCACCAAGGGTATACGA	intergenic
ATACCTATCAGGGTTACCCA	intergenic
ACCTAGATCAGGGTAACCAC	intergenic
GAATAGCGTAGGGTTTCATA	intergenic
GTAGACGTGGGTGCACATCT	intergenic
GATTTGCAAGGGCATCAATA	intergenic
AGAGTTATACCCGGGCATGT	intergenic
GAGCTGAAAGGCGTATGGGT	intergenic
TAAGATATGGGACATATAGG	intergenic
ACTGTTATAGGGGAGTAATT	intergenic
TAGCTAGATGGGTAGGATAA	intergenic
AAGTTAAGAGGGCTATTGGT	intergenic
GTATACACAGGGGTATATAC	intergenic
TCTGAATAGGGGCTACGATA	intergenic
GTATCATTGGGACTAATGGT	intergenic
CATATATGGGGACTCAATGG	intergenic
TAATTCATGGGGCTATCATA	intergenic
